++++++++++++++++++++
++s+++++++++++++++++
++ +++++++++++++++++
++          ++++++++
+++++++++++ ++++++++
+++++++++++ ++++++++
+++++++++++ ++++++++
+++++++++++ ++++++++
+++++++++++ ++++++++
+++++++++++ ++++++++
+++++++++++ ++++++++
+++++++     ++++++++
+++++++ ++++++++++++
+++++++     ++++++++
+++++++++++ ++++++++
+++++++     ++++++++
+++++++ ++++++++++++
+       ++++++++++++
+e++++++++++++++++++
++++++++++++++++++++
