++++++++++++++++++++
++s++++ +++++++ ++++
++ ++++ +++++++ ++++
++       x  +++ ++++
+++ +++++++ +++  x +
+++ +++++++ ++++++++
+++ +++++++ ++++++++
+++x+++++++      +++
+++   +++++ ++++ +++
+++++++++++ ++++x+++
+++++++++++ ++++ +++
+++++++     ++++++++
+++++++ ++++++++++++
+++++++     ++++++++
+++++++++++ ++++++++
+++++++       x  +++
+++++++ ++++++++++++
+    x  ++++++++++++
+e++++++++++++++++++
++++++++++++++++++++